|||||||||||||||||||||||||||||||||||||||||||||||||||
|   |       |   #####       |         |           |
| | ||| ||| ||||||||||| ||| | ||||||| ||| ||||||| |
| |   | | |           | | |   |     |     |   | | |
| ||| | | |||###||||| | | ||||| ||||||||||||| | | |
| | |   |           | | | ##  |       |       | | |
| | ||||| ||| ||||||| | | | ||| ||| ||| ||| | | | |
| |         | |   #   | | |     |   |   | | |   | |
| | ||||||| ||||| ||||| ||||| ||| ||| ||| | ||| | |
| | |     |   |   |     |   |   |         | | | | |
| ||| ||| ||| ||| ||| ||| | ||| ||||||||||| | | | |
| |   |       | | | |  A  | |   | |       | |   | |
| | ||||||#|| | ||| ||| ||| ||| | | ||||| | | ||| |
| |    #|   | |   |   |   |   |   | |     | | |   |
| | | ##| ||| ||| ||| ||||||| ||| | ||| ||| | | |||
| | |## |    #  |   | |  ###  |   |   |     | | | |
| | |## ||||||| | | | | ||#|||| ||||| ||||||| | | |
| | |##     |   | | |   |     |   | |       ##|   |
| ||||||||| | ||| ||||||| ||||||| | ||||| | ##||| |
| |#      | |     |     |       |   |   | | ##  | |
| | ||||| | ||||||| | ||| ||||| ||| | | |||#||||| |
|###|     |         |  ###|## |     | |   |###### |
| ||| |||||||||||||||||||||#| ||||||| ||| |#    # |
|   |                 ######|##     #   |    ##   |
|||||||||||||||||||||||||||||||||||||||||||||||||||
